R 1000 500
NO ./textures/colorstone.xpm
SO ./textures/greystone.xpm
WE ./textures/purplestone.xpm
EA ./textures/bluestone.xpm
S ./textures/barrel.xpm

F 25,25,112
C 135,206,235
1111111111111111                    11111111111111111
1200000000000001                    10000000000000001
1000000000000001                    10000000000000001
1000000000000001                    10000000000000001
1000000000000001                    10000000200000001
1000000000000001                    10000000000000001
1000000000000001                    10000000000000001
1111110000111111                    11111110000111111
     100001      11111111111111111        100001
     100001      10000000000000001        100001
     100001      10000200200200001        100001
     100001      10000020002000001        100001
     100001      10000002020000001        100001
     1000011111111000000020000000111111111100001
     1000000000000000000000000000000000000000001
     10000000000000200000N0000000000000000000001
     1111111111111000000000000000111111111111111
                 10000000000000001
                 10000000000000001
                 10000000000000001
                 1000000000000000111111
                 1111111111111111000001
                                1002001
                                1000001
                                1111111
