R 500 500
NO ./textures/mossy.xpm
SO ./textures/wood.xpm
WE ./textures/purplestone.xpm
EA ./textures/eagle.xpm
S ./textures/barrel.xpm

F 25,25,112
C 135,206,235

        1111111111111111111111111
        1         11            1
        1 11     111      2     1
        1  1                    1
111111111 11     111            1
1         11     111 11111 111111
1111 111111111 111      1   1
1111 111111111 111 1 1  1   1
11      11 1 1 111      1 N 1
1   2           11      1   1
1               11 1 1  1   1
11     111 1 1 11111 1111   111
1111 111 111 1 1 1 1111 1   1
11111111 1111111 111111111111
