R 1920 1080
NO ./../textures/bluestone.xpm
SO ./../textures/greystone.xpm
WE ./../textures/colorstone.xpm
EA ./../textures/redbrick.xpm
S ./../textures/barrel.xpm
F 220,100,0
C 225,30,0
11111111111111111111111111111
10000000000000000000000000001
10000000000000000000000000001
10011111111111111111111111001
10011111111111111111111111001
10011111111111111111111111001
10011111111111111111111111001
10011111111111111111111111001
100N1111111111111111111111001
10000000000000000000000000001
10000000000000000000000000001
11111111111111111111111111111
