R 500 500
NO ./textures/mossy.xpm
SO ./textures/wood.xpm
WE ./textures/purplestone.xpm
EA ./textures/eagle.xpm
S ./textures/barrel.xpm

F 25,25,112
C 135,206,235

111111111111111111111111111111111111
122222222222222222222222222222222221
122222222222222222222222222222222221
122222222222222222222222222222222221
122222222222222222222222222222222221
122222222222222222222222222222222221
122222222222222222222222222222222221
122222222222222222222222222222222221
1222222222222222222S2222222222222221
122222222222222222222222222222222221
122222222222222222222222222222222221
122222222222222222222222222222222221
122222222222222222222222222222222221
122222222222222222222222222222222221
111111111111111111111111111111111111

