R 1920 1080
NO ./textures/mossy.xpm
SO ./textures/wood.xpm
WE ./textures/purplestone.xpm
EA ./textures/eagle.xpm
S ./textures/barrel.xpm
F 220,100,0
C 225,30,0
11111111111111111111111111111
10000000000000000000000000001
10000000000000000000000000001
10011111111111111111111111001
10011111111111111111111111001
10011111111111111111111111001
10011111111111111111111111001
10011111111111111111111111001
10011111111111111111111111001
10000000000000000000000000001
100000000N0000000000000000001
11111111111111111111111111111
