R 1920 1080
NO ./../textures/bluestone.xpm
SO ./../textures/greystone.xpm
WE ./../textures/colorstone.xpm
EA ./../textures/redbrick.xpm
S ./../textures/barrel.xpm
F 220,100,0
C 225,30,0
        11111111111111111111111
        1000000000110000000000111111111111
        10110000011100000020002002200200201
        1001000000000000000000111111111111
1111111110110000011100000000001
1000000000110000011101111101111
11110111111111011100000010001
11110111111111011101010010001
11000000110101011100000010001
11002000000000001100000010001
11000000000000001101010010001111
11000001110101011111011110N00001
11110111 1110101 101111010001111
11111111 1111111 111111111111
